#######
##  @ #
##. $ #
## .  #
####$ #
####  #
#######