#######
##@.  #
## $  #
##    #
#   $##
#   .##
#######