#######
#    ##
# $ .##
#  .###
##$ ###
##@####
#######