#######
#. ####
#   $@#
# .#  #
# ##$ #
#     #
#######