#######
###.  #
### . #
### $ #
### $@#
###   #
#######