#######
# #####
# @####
# $####
#  ####
# .$. #
#######