#######
# . $@#
# $  ##
#   .##
##   ##
### ###
#######