#######
##.  .#
##    #
##@$  #
####$ #
####  #
#######