#######
#######
# @####
# $ ###
#  ####
# $ ..#
#######