#######
##  @##
## $$##
#    ##
#   . #
# .   #
#######