#######
#######
#. ####
#  ####
#$.$ ##
#@   ##
#######