#######
#######
#######
# # . #
#. $$ #
#   @ #
#######