#######
#### .#
## $  #
##  . #
#### $#
###  @#
#######