#######
###   #
### $ #
####  #
### .##
###.$@#
#######