#######
# #####
#     #
# .$  #
#  #$ #
#   @.#
#######