#######
### . #
### $ #
####@ #
### $ #
###.  #
#######