#######
#  ####
#  .###
#. ####
#$$####
# @   #
#######