#######
#######
# #####
#  ####
# $.###
#@$ .##
#######