#######
# .   #
#  $  #
###.  #
####$ #
####@ #
#######