#######
# $.  #
#@$  .#
# #####
#     #
#    ##
#######