#######
###@. #
###$  #
###   #
##  $ #
## .  #
#######