#######
#######
### ###
#.  $@#
#  $ ##
# .####
#######