#######
#  .###
#  $@##
# $ ###
# . ###
#######
#######