#######
####..#
####  #
####  #
####$$#
####@ #
#######