#######
#######
###  ##
## $ ##
#   $@#
#..  ##
#######