#######
#  @ ##
# $$###
##.  ##
##  .##
##  ###
#######