#######
#######
#######
##@####
# $$ .#
#   . #
#######