#######
#  .  #
# $$ .#
# @####
# #####
#######
#######