#######
#@ ####
#$$####
#. ####
#  ####
#  .###
#######