#######
# . $ #
#@$   #
###  .#
####  #
####  #
#######