#######
###  @#
###  $#
### . #
### $.#
###   #
#######