#######
#   . #
# $   #
#  .###
###$###
#  @###
#######