#######
###  .#
###$  #
###   #
###.$##
#   @ #
#######