#######
#  ####
# $####
#  #.##
#@$   #
#   . #
#######