#######
# .$  #
#@$   #
# ##  #
#  ##.#
#  #  #
#######