#######
#  .###
# $ ###
# @####
# $ ###
# . ###
#######