#######
#. ####
#$ ####
#@#####
#$#####
#.  ###
#######