#######
#. ####
#  ####
# #####
#$## ##
#@$.  #
#######