#######
#  ####
## @. #
## $ ##
# . $ #
##    #
#######