#######
##   ##
# . .##
# $$ ##
#  @ ##
#######
#######