#######
### ###
###.###
### $ #
##@$  #
### . #
#######