#######
#######
# ##  #
#@$ . #
#   $ #
# .   #
#######