#######
###   #
### $##
###   #
###  .#
#@$ . #
#######