#######
# #####
#. ####
# .####
#$$####
# @####
#######