#######
####..#
####  #
####  #
####$$#
#### @#
#######