#######
###@  #
###$  #
##  $ #
##. .##
##    #
#######