#######
#   ###
#  . ##
#.$  ##
#  $###
#  @###
#######