#######
# .   #
#     #
##.  ##
##$ $##
##  @##
#######