#######
#  ####
#.#####
# . ###
#$$####
#@  ###
#######