#######
#.. # #
#$ #  #
#  #  #
##  $ #
##  @ #
#######