#######
####. #
####  #
#@$   #
# $   #
#   . #
#######