#######
#####.#
##### #
####  #
####$$#
####.@#
#######