#######
#######
####  #
###   #
###$ ##
#@$. .#
#######