#######
#######
##### #
###.$ #
#@$  .#
#    ##
#######