#######
#####@#
#### $#
####$ #
####..#
####  #
#######