#######
###@  #
###$$ #
### .##
# #.  #
#     #
#######