#######
####  #
#####.#
####  #
# ##$$#
#  . @#
#######