#######
# .$@ #
# . $ #
#    ##
#######
#######
#######