#######
#    ##
# $  ##
###.  #
###$  #
## @ .#
#######