#######
#@ ####
#$$####
#..####
#  ####
#   ###
#######