#######
#######
#######
###   #
#@$   #
#. $. #
#######