#######
#######
###@###
# .$$ #
#    .#
#     #
#######