#######
##    #
#. $  #
### . #
###$# #
#  @  #
#######