#######
#    .#
# $ $@#
# .####
#######
#######
#######