#######
# .####
# $ ###
#@. ###
# $ ###
#   ###
#######