#######
#######
#.#.###
#@$ ###
# $ ###
#  ####
#######