#######
### . #
###.$@#
####$ #
####  #
##### #
#######