#######
#@$  .#
# $  .#
# #####
#   ###
# # ###
#######