#######
###   #
### $ #
###@$.#
###   #
### . #
#######