#######
####  #
## .$@#
## $  #
##    #
#####.#
#######