#######
#.#####
#$ ####
#@#####
#$ ####
#. ####
#######