#######
#     #
# $@. #
####$ #
####  #
####. #
#######