#######
#####.#
##### #
###   #
### $$#
### .@#
#######