#######
#@  ###
#$#####
#  ####
#  ## #
#. $ .#
#######