#######
# @####
#$$####
#  ####
#..   #
# #   #
#######