#######
##@####
# $####
# . ###
#  ####
# $.###
#######