#######
#  ####
#. ####
# #####
#$$ . #
#@    #
#######