#######
# @   #
# $$  #
#  .#.#
## ## #
#######
#######