#######
# .####
# $####
# @####
# $   #
# .####
#######