#######
##  .##
#    .#
#     #
# $$ ##
#  @  #
#######