#######
#@  .##
#$ $ ##
#  ####
#. ####
#  ####
#######