#######
#######
#######
#@.$. #
# $####
#  ####
#######