#######
# ## ##
# .$ ##
#   .##
# $####
# @####
#######