#######
##   @#
#   $.#
##.#  #
####$ #
####  #
#######