#######
#### .#
###@$ #
####  #
#### $#
#### .#
#######