#######
###   #
# $  .#
#    $#
###  @#
#####.#
#######