#######
#@$  .#
# $.  #
#######
#######
#######
#######