#######
#### ##
#     #
#   ..#
# $ $ #
# @   #
#######