#######
# @####
# $####
#     #
#  $. #
#. #  #
#######