#######
#### @#
####$$#
####  #
#### .#
####. #
#######