#######
#######
##.####
#   ###
#   $ #
#.  $@#
#######