#######
#.    #
#  $ ##
#  ####
# $####
#.@ ###
#######