#######
#.  $ #
#   $@#
# #####
#.#####
# #####
#######