#######
#     #
#. .  #
# # $@#
#   $ #
#    ##
#######