#######
###  @#
####$$#
####. #
#### .#
####  #
#######