#######
###@###
#. $  #
#   $ #
#. #  #
#######
#######