#######
#    ##
# .  ##
##$  ##
## $ ##
## @.##
#######