#######
###.. #
##    #
#  $ ##
# $  ##
# @####
#######