#######
#######
#######
####  #
###.$@#
#. $ ##
#######