#######
#######
#@ ####
#$#  ##
# $. ##
#.  ###
#######