#######
#@$ . #
## $  #
#### .#
####  #
####  #
#######