#######
##### #
#### .#
## $  #
##@$  #
#### .#
#######