#######
#@.  ##
##$$ ##
#  ####
#   ###
#  .###
#######