#######
##@   #
##$$. #
#  ####
#  ## #
#   . #
#######