#######
#######
#   ###
#. $@##
#$  ###
#.   ##
#######