#######
#######
### ###
#.$@###
# $ ###
# .  ##
#######