#######
#..  ##
#     #
#  $  #
####$ #
### @##
#######