#######
### @##
## $$ #
##.   #
####. #
####  #
#######