#######
#  ####
#.   ##
# $.###
#   $@#
#   ###
#######