#######
#######
#######
# .#  #
# $$ .#
# @   #
#######