#######
#. ####
#  ####
#   $ #
# $   #
#@.   #
#######