#######
##. @ #
## $$ #
### . #
####  #
#######
#######