#######
##### #
##### #
####  #
###.$@#
###.$ #
#######