#######
###  ##
### . #
####  #
####$ #
###.$@#
#######