#######
#   @ #
# $ $ #
# #   #
# ##  #
# ##..#
#######