#######
##   @#
##  $$#
# .#  #
#  ## #
#   #.#
#######