#######
#@$ . #
# $.# #
#  ####
# #####
#######
#######