#######
##    #
## .  #
##  $ #
##.$###
###@###
#######