#######
####@ #
####$ #
####. #
## .$ #
###   #
#######