#######
#     #
#@$ $ #
###.  #
###. ##
#######
#######