#######
#     #
#  .  #
###$$ #
## @.##
##   ##
#######