#######
#    ##
# .  ##
###. ##
###$$ #
###@  #
#######