#######
#@  ###
#$$ ###
#. .###
# #####
#######
#######