#######
##    #
##. $ #
## .###
## $###
## @###
#######