#######
#######
#.  ###
#  ####
#$#####
#@$  .#
#######