#######
# # ###
# $.  #
#@$   #
###   #
#### .#
#######