#######
#@$  .#
#. $  #
#######
#######
#######
#######