#######
#######
#  ####
#.   ##
# $ $ #
#.@   #
#######