#######
#######
#######
#######
#  $ .#
#.  $@#
#######