#######
####  #
### . #
#.@$  #
#   $ #
####  #
#######