#######
#.  ###
#   ###
# $####
# $@###
# .####
#######