#######
#  .###
#  ####
# $####
#  $@##
#. ####
#######