#######
####  #
#### $#
####  #
#### .#
###@$.#
#######