#######
##. ###
#   ###
#  ####
# $$. #
# @   #
#######