#######
##@.  #
## $  #
##   .#
##  $ #
####  #
#######