#######
# $ . #
#@$  .#
###   #
#######
#######
#######