#######
##    #
## .$@#
####$ #
####  #
####. #
#######