#######
###  .#
###  .#
###   #
####$$#
###  @#
#######