#######
#  @ ##
# $$ ##
#   ###
# .   #
#.  ###
#######