#######
#.@####
# $####
#   ###
# $ ###
#.  ###
#######