#######
#    ##
#.$@#.#
## #  #
#  $  #
##    #
#######