#######
#######
### @ #
# # $$#
#  #  #
# .  .#
#######