#######
#######
#######
#####.#
#@$   #
# $.  #
#######