#######
#  . ##
# $ ###
# # ###
# # $@#
# .   #
#######