#######
#####.#
##### #
#### $#
###   #
#@$  .#
#######