#######
#  ..##
#   ###
#@$  ##
# $ ###
#    ##
#######