#######
#######
#######
#######
# ### #
#.$@$.#
#######