#######
##.   #
###  .#
### $ #
##   $#
###  @#
#######