#######
#######
#######
## .###
###$  #
#@$  .#
#######