#######
#.  $ #
# @$. #
#     #
#######
#######
#######