#######
### . #
#### ##
###   #
#. $$ #
#   @ #
#######