#######
#    ##
# .  ##
#  $###
# $  ##
##@. ##
#######