#######
####  #
###  .#
##.   #
# $ $ #
#   @ #
#######