#######
## @ ##
##$$###
##. ###
# #  ##
#  .###
#######