#######
### . #
### $ #
### @ #
### $ #
### . #
#######