#######
####  #
## $..#
##    #
####$ #
####@ #
#######