#######
#  @ ##
# $$ ##
#.   ##
#    ##
#.   ##
#######