#######
#  .###
#   ###
#    ##
# $ $ #
# @  .#
#######