#######
#######
###  .#
###  .#
### $$#
#### @#
#######