#######
#     #
# . $ #
#.#  ##
# #$ ##
#  @  #
#######