#######
####. #
####  #
####  #
## $$ #
##. @ #
#######