#######
# ## .#
#  .$ #
#    $#
#####@#
#######
#######