#######
#### .#
####  #
####$ #
#### $#
####.@#
#######