#######
##  @ #
## $$ #
## #  #
#  #. #
# . ###
#######