#######
#     #
#@$   #
## .  #
##$ . #
##    #
#######