#######
##### #
#  #@ #
#  $$ #
#.  . #
##### #
#######