#######
#    ##
# .  ##
#@$  ##
# $####
#  .###
#######