#######
#######
#######
###   #
#@$   #
#. .$ #
#######