#######
##. ###
#    ##
#.$ ###
#$  ###
#@#####
#######