#######
#######
#  ####
# $####
#. $@##
#    .#
#######