#######
####. #
####$.#
####  #
#####$#
#####@#
#######