#######
#######
###  @#
# $ $.#
#     #
#.    #
#######