#######
#   ###
# .$@##
# $ ###
# # ###
#  .###
#######