#######
#    ##
# $ . #
#@$   #
###.# #
####  #
#######