#######
#  .###
#.  $ #
## ## #
##$## #
# @   #
#######