#######
#.    #
#   $@#
#  .$##
# #  ##
#  ####
#######