#######
#######
# ##@##
#   $ #
#.    #
# $ . #
#######