#######
#######
# @####
# $ ###
#..$ ##
#     #
#######