#######
#   .##
#    ##
## .###
#  $$ #
#  @  #
#######