#######
#  .@ #
# $ $ #
###  .#
####  #
#######
#######