#######
#    ##
# $ $@#
###  ##
###..##
#######
#######