#######
# $  .#
# .   #
####$ #
####@ #
##### #
#######