#######
#.  $@#
# . $ #
### ###
#######
#######
#######