#######
###  ##
### $.#
### . #
###@$ #
##    #
#######