#######
#######
#######
#  ..##
## $$ #
## @  #
#######