#######
#    ##
#. . ##
###  ##
###$$ #
###@  #
#######