#######
#  @  #
# $$  #
###  ##
##    #
##. .##
#######