#######
#     #
#@$ . #
####  #
####$.#
###   #
#######