#######
#. .  #
#  #$ #
####@ #
####$ #
####  #
#######