#######
# .$@##
#.$ ###
#  ####
##  ###
## ####
#######