#######
#    ##
# .$ ##
#   ###
#  $ ##
#. @ ##
#######