#######
#.. $ #
###   #
####$ #
####@##
#######
#######