#######
####@.#
####$ #
#### $#
####  #
### . #
#######