#######
#### .#
####. #
####  #
## $$ #
##  @ #
#######