#######
### @ #
####$.#
#### $#
####  #
####. #
#######