#######
##    #
## .$ #
##  $@#
##    #
#    .#
#######