#######
# @####
# $## #
#   $ #
#. .  #
#    ##
#######