#######
##.   #
##  $@#
##. $ #
##    #
#######
#######