#######
# .  ##
# $  ##
#  .$ #
# # @ #
##### #
#######