#######
###@###
##.$  #
##  . #
## $  #
##    #
#######