#######
### @ #
### $ #
####. #
###.$ #
###   #
#######