#######
#  @  #
# $$ .#
##   .#
#######
#######
#######