#######
#######
# @####
# $ $ #
#   . #
#. ####
#######