#######
#######
#######
# .####
# $ ###
#@$.###
#######