#######
#  .$ #
#   $@#
# .####
#######
#######
#######