#######
#######
# #####
#  @ ##
# $$ ##
# . .##
#######