#######
# ##  #
#@$ $ #
#.    #
#####.#
##### #
#######