#######
#    ##
#. @ ##
# #$###
# $.###
#   ###
#######