#######
###@ .#
###$ ##
###  ##
#.$  ##
#     #
#######