#######
# . ###
# $####
# @####
# $####
# .####
#######