#######
#   .@#
#   $ #
#  $. #
#     #
#######
#######