#######
#######
#######
#######
#     #
#.$@$.#
#######