#######
# @####
#.$####
#$ ####
#  ####
# .####
#######