#######
####@ #
# .#$ #
#  $. #
#     #
#######
#######