#######
#@$ . #
# $.  #
####  #
##### #
#######
#######