#######
#    ##
#  $@##
# $  ##
#   ###
#. .###
#######