#######
#. . ##
# $   #
# #   #
#$#####
#@#####
#######