#######
####  #
####  #
##  # #
# . $@#
#  .$ #
#######