#######
#   ###
# $ ###
#  .###
#.$####
# @   #
#######