#######
#    ##
# $  ##
### $@#
#.   ##
##  . #
#######