#######
#### @#
####$$#
###   #
###.  #
###  .#
#######