#######
#  ####
# $####
#   ###
#@$ . #
#  .###
#######