#######
#  .  #
#  $ ##
# $ ###
# @ ###
#.#####
#######