#######
#@ ####
#$$  ##
# .####
# #####
#.#####
#######