#######
#     #
# $ . #
# .#  #
# $## #
# @####
#######