#######
#   @ #
#. $$ #
# .#  #
# ##  #
# ### #
#######