#######
#  ####
# $# ##
#@$   #
#   . #
# .#  #
#######