#######
### . #
####$ #
###@$.#
###   #
#######
#######