#######
# . .##
# $  ##
#  ####
# $####
# @  ##
#######