#######
#@ ####
#$##  #
# $  .#
#.  # #
# ##  #
#######