#######
# #. ##
#     #
# $ $@#
# .####
#  ####
#######