#######
#  .$ #
# . $@#
##### #
####  #
####  #
#######