#######
# #####
# $ .##
# . ###
# $ ###
# @####
#######