#######
#  #  #
# . $@#
#   # #
#  .$ #
#  #  #
#######