#######
####  #
#### .#
####. #
### $$#
####@ #
#######