#######
#   . #
#   $@#
#     #
##$   #
#.   ##
#######