#######
# $  .#
#@$   #
###   #
####  #
#####.#
#######