#######
#    .#
##  . #
#    ##
# $ $##
# @  ##
#######