#######
##    #
#@$ $ #
#     #
#  .###
#   .##
#######