#######
#  @  #
# $$ ##
###   #
###   #
### ..#
#######