#######
#  @  #
# $.$ #
#  ## #
# ##  #
#### .#
#######