#######
#  .###
# $####
# @####
# #####
# $  .#
#######