#######
#.  $ #
#   $@#
#. ####
#   ###
#######
#######