#######
###. ##
###$ ##
#    ##
# $.  #
# @   #
#######