#######
##    #
#@$   #
#  .  #
# $   #
#### .#
#######