#######
####  #
####$ #
# ##  #
#@$  .#
#    .#
#######