#######
#   ..#
# $   #
#  ## #
# $## #
# @ ###
#######