#######
#######
#######
# .####
# $####
#.$@###
#######