#######
#######
##  ###
#@$.###
# .$ ##
#     #
#######