#######
#. $@##
# $####
##  ###
#     #
#  .  #
#######