#######
#.$.# #
#     #
# ##  #
#   $ #
#   @ #
#######