#######
#######
#   ###
# ..###
# $$###
#  @###
#######