#######
# . . #
#     #
##$$###
## @###
#######
#######