#######
#####.#
####. #
####  #
####$$#
###  @#
#######