#######
###@###
#  $###
# $  ##
#  .  #
#  .  #
#######