#######
##### #
####  #
#  .$ #
# $.  #
# @  ##
#######