#######
###.@ #
###$$ #
###   #
####. #
##### #
#######