#######
# @   #
# $ $ #
# .####
# .####
#  ####
#######