#######
##@  ##
# $ $ #
#  .  #
# #  ##
# .  ##
#######