#######
#@ ####
#$$####
#  ####
#   ###
#. . ##
#######