#######
#######
#######
#######
####  #
#.$@$.#
#######