#######
#######
#######
# #   #
#.  $ #
#@$ . #
#######