#######
#    .#
#    ##
##$  ##
##.$ ##
## @ ##
#######