#######
#. ####
#$#####
#.@####
#$ ####
#  ####
#######