#######
####@ #
####$ #
####. #
###.$ #
###   #
#######