#######
#  . ##
#.   ##
#  $###
# $   #
##@   #
#######