#######
###  .#
###. $#
### $ #
### @ #
#######
#######