#######
#######
#######
# #####
#.  $@#
#  $. #
#######