#######
#@$  .#
## $  #
##.####
##  ###
##  ###
#######