#######
####. #
####$ #
####@ #
####$ #
####. #
#######