#######
#     #
#   $@#
# .$  #
###   #
### . #
#######