#######
##@$.##
###$###
##   ##
##  . #
##    #
#######