#######
#######
#### ##
###.  #
#@$   #
#.  $ #
#######