#######
#######
#######
#######
#.$@$.#
#     #
#######