#######
#######
# ##. #
# @#  #
# $$  #
# .   #
#######