#######
### . #
### $ #
####@ #
####$ #
####. #
#######