#######
#######
#######
# ## ##
#.  $@#
#  $ .#
#######