#######
#   . #
# $$  #
# @# .#
####  #
##### #
#######