#######
##### #
#  ## #
#. $. #
#$    #
#@#####
#######