#######
###  @#
####.$#
####$ #
####  #
#### .#
#######