#######
###.$ #
##@$  #
##    #
##### #
#### .#
#######