#######
#    @#
#  # $#
#  #. #
# ##$ #
#    .#
#######