#######
##  ###
#@$. ##
#    ##
#  $ ##
# .   #
#######