#######
####. #
####$ #
### @ #
### $##
### .##
#######