#######
###   #
###  .#
####  #
## $$ #
##  @.#
#######