#######
#######
#####@#
# ## $#
#. $ .#
#     #
#######