#######
##  @##
## $$ #
## .  #
## .  #
### ###
#######