#######
#######
#####.#
###   #
### $$#
### @.#
#######