#######
##.   #
##$ . #
##  ###
###$###
###@###
#######