#######
##  ###
# $ . #
#   # #
#  $  #
# @.  #
#######