#######
#.  $@#
#  $ ##
# #  .#
# #####
#######
#######