#######
# #####
#  ####
# .####
# $####
#@$.###
#######