#######
# .$@##
#    ##
# #####
#  ####
# $. ##
#######