#######
#### .#
#### $#
####@.#
#### $#
####  #
#######