#######
# @####
#$$####
#  ####
#  ####
#..####
#######