#######
#######
#  ####
# .####
# $  ##
#@.$ ##
#######