#######
#######
##  . #
## $  #
##@$  #
### . #
#######