#######
#  ####
# $ $@#
#    ##
#.   ##
#  .  #
#######