#######
#####.#
####  #
####. #
####$$#
##   @#
#######