#######
#.#   #
#  $@##
#    ##
# $####
#. ####
#######