#######
####  #
# ##  #
#@$   #
# $ . #
##   .#
#######