#######
#.  ###
#.  ###
# $ ###
# $@###
#   ###
#######