#######
#     #
#   $ #
#..  ##
#  $###
## @###
#######