#######
# #.  #
#   . #
#   $@#
### $##
###  ##
#######