#######
# @####
# $####
#   ###
#  $  #
# .  .#
#######