#######
#. ####
# #####
#  ####
#$$ ###
#.@ ###
#######