#######
## ####
##  . #
##$  ##
#@$ .##
#     #
#######