#######
### . #
### $ #
###.$@#
##### #
####  #
#######