#######
#   .##
# $ ###
# .$@##
#  ####
# #####
#######