#######
# @.###
# $ ###
#   ###
# $ ###
#.  ###
#######