#######
####  #
####. #
## #$ #
#  .$@#
#     #
#######