#######
# #####
# #####
# .####
# $####
#@$.###
#######