#######
#     #
# $  .#
###.  #
### $@#
###  ##
#######