#######
# .$  #
#  # .#
#### $#
#####@#
#######
#######