#######
#    ##
#.$   #
#  .$ #
### @##
#######
#######