#######
##   ##
## .  #
## $ .#
### $@#
###   #
#######