#######
##@## #
# $   #
#.  $ #
#  .###
#    ##
#######