#######
#     #
#.  $ #
##.   #
###$###
## @ ##
#######