#######
#     #
#   $ #
#.. ###
# $####
##@####
#######