#######
#    ##
# $  ##
#@$   #
#  .  #
#   . #
#######