#######
#    @#
# . $$#
#  ##.#
####  #
##### #
#######