#######
###.  #
### $ #
##  $@#
## .  #
##   ##
#######