#######
#   . #
# .   #
### $ #
### $@#
###   #
#######