#######
#    ##
#  .$@#
# $.###
#######
#######
#######