#######
#     #
#   $@#
#.$.###
# #####
#######
#######