#######
#######
#######
###@  #
###$$ #
# ..  #
#######