#######
#  .###
#    ##
#@$ ###
# $. ##
#   ###
#######