#######
#######
#######
# .$@##
#.$  ##
#    ##
#######