#######
#    .#
# $  .#
##  ###
##$ ###
# @####
#######