#######
# .  .#
#     #
# $$###
##@ ###
#######
#######