#######
#   . #
# $   #
##  # #
##$ . #
##@#  #
#######