#######
####  #
## $  #
##   .#
####$ #
####@.#
#######