#######
#######
#######
# ### #
#.$.$ #
#  @  #
#######