#######
##    #
## .  #
##@$  #
### $ #
###  .#
#######