#######
#   @ #
#  $$ #
# .  ##
#     #
##.   #
#######