#######
####  #
####..#
###   #
### $$#
###  @#
#######