#######
####  #
####  #
####. #
#@$   #
# $ . #
#######