#######
#### .#
####  #
####. #
####$$#
###  @#
#######