#######
# #####
#.@####
#$$####
#  ## #
#    .#
#######