#######
#  . ##
# $$.##
# @####
#######
#######
#######