#######
###   #
###.$ #
###   #
###$  #
###@. #
#######