#######
#######
#  .  #
# $   #
#  .$ #
##  @ #
#######