#######
##   .#
### $ #
###@$ #
###  .#
###   #
#######