#######
# .. ##
#   ###
##$  ##
#  $@##
#   ###
#######