#######
#   ###
#  .###
#   $@#
# $ ###
#.  ###
#######