#######
#     #
#@$   #
#### .#
####$ #
#### .#
#######