#######
#  . ##
#   .##
#  ## #
# $ $ #
# @   #
#######