#######
# ###@#
#    $#
# $ ..#
#######
#######
#######