#######
##    #
###   #
###.$ #
### $@#
###.  #
#######