#######
#   ###
#  .###
#@$ ###
# $.# #
#     #
#######