#######
#. ####
#  ####
#$. $@#
#   ###
# #####
#######