#######
#    ##
# $ $@#
#  . .#
# ##  #
####  #
#######