#######
#######
#######
#. # ##
#.$@$ #
#     #
#######