#######
#######
##@   #
# $   #
#    .#
# . $ #
#######