#######
#. ####
#  ####
# $####
#$.####
#@ ####
#######