#######
# $ . #
#.  $@#
#   ###
#######
#######
#######