#######
####.@#
#### $#
####$ #
####  #
#####.#
#######