#######
# .####
#  ## #
#   $ #
# .$@ #
#  #  #
#######