#######
#######
####@ #
##.$$ #
####  #
# .   #
#######