#######
##    #
## .@ #
##  $ #
## $. #
##    #
#######