#######
#######
###.# #
#     #
#@$.$ #
####  #
#######