#######
#@$. ##
# $ ###
# . ###
#######
#######
#######