#######
#######
# #  ##
#   $@#
#. $ ##
#. ####
#######