#######
# . $@#
#. $ ##
#  ####
# #####
#######
#######