#######
##    #
###.  #
####$ #
###   #
#@$ . #
#######