#######
##### #
## ## #
# . $ #
#@$ . #
# #   #
#######