#######
#.  $@#
#  $ ##
#    ##
#. # ##
# #####
#######