#######
#@ ####
#$$####
#. ####
#  ####
# .####
#######