#######
#.  $ #
#   $@#
# #####
#.#####
#######
#######