#######
## @  #
## $$.#
##   ##
##  ###
###.###
#######