#######
#     #
#@$ . #
# .#  #
# $####
#  ####
#######