#######
#######
#######
## .# #
#. $$ #
#  @  #
#######