#######
##.$ ##
#@$  ##
##  .##
#######
#######
#######