#######
##.  .#
## $  #
##    #
### $@#
###   #
#######