#######
#### @#
####$$#
#### .#
####. #
####  #
#######