#######
#     #
#$. $@#
# #####
#. ####
#######
#######