#######
#     #
# .$@ #
### .##
#  $ ##
#     #
#######