#######
#  ####
# $ $@#
# . . #
##    #
#######
#######