#######
##    #
## .$@#
#   $ #
# .  ##
# #####
#######