#######
#.  $ #
##  . #
###$ ##
###@###
#######
#######