#######
###@ ##
###$$##
###. ##
###   #
#   . #
#######