#######
#######
#. ####
#  ####
#  $@##
#  $. #
#######