#######
##  @ #
##$ $ #
#     #
#.  ###
#    .#
#######