#######
# @# ##
# $ $ #
#     #
##. ###
#  .###
#######