#######
# $.  #
#   $@#
#.   ##
#######
#######
#######