#######
#### .#
####$ #
####  #
#@$  .#
#     #
#######