#######
#######
#### ##
#### ##
###@$.#
### $.#
#######