#######
#     #
#@$.$ #
# #.  #
# ##  #
# ### #
#######