#######
#.   ##
#  . ##
#    ##
# $$ ##
###@  #
#######