#######
#######
#######
#######
#.  $@#
#  $. #
#######