#######
#     #
#.$@$ #
# ##  #
#  ## #
#. ####
#######