#######
#  @  #
# $.$ #
###  .#
#######
#######
#######