#######
#######
#####.#
###.$ #
#   $@#
#   # #
#######