#######
#  ####
# $####
#@.####
# $####
# .####
#######