#######
#######
#######
#   #.#
#@$ .$#
#     #
#######