#######
# @####
#$$####
# .####
#. ####
#     #
#######