#######
####. #
####  #
#### $#
####$.#
### @ #
#######