#######
#   .##
#    ##
# $$ ##
##.####
##@####
#######