#######
#@  ###
#.$ $ #
#   . #
#     #
#######
#######