#######
#### .#
#####$#
####@.#
#### $#
####  #
#######