#######
###.###
#   ###
# $ ###
#@$ ###
#    .#
#######