#######
##  @ #
#   $ #
#  $  #
#.  . #
# #####
#######