#######
##. . #
##  $ #
####  #
####$ #
####@ #
#######