#######
####  #
####  #
####..#
####$$#
#### @#
#######