#######
#######
#     #
#..   #
#  $$ #
# # @ #
#######