#######
###@###
###.###
# $$ ##
# .   #
#     #
#######