#######
####  #
####  #
####..#
####$$#
####@ #
#######