#######
# @  ##
# $ ###
#$. ###
#.  ###
# #####
#######