#######
####@.#
####$ #
####. #
## $  #
##    #
#######