#######
# #####
#    ##
#.  $@#
#  $  #
#.    #
#######