#######
# ..###
# $ ###
# @####
# $####
#     #
#######