#######
####. #
#### .#
####$ #
#### $#
#####@#
#######