#######
#######
# #####
# . $ #
#@$   #
#   . #
#######