#######
##   ##
##. ###
##  # #
# $$. #
# @   #
#######