#######
#.    #
# ##  #
# $ $.#
##  @ #
#######
#######