#######
####  #
####$ #
### . #
##@$  #
##  .##
#######