#######
#.  $ #
#   $@#
#  . ##
#  ####
# #####
#######