#######
###   #
### $ #
#   $@#
#     #
# . . #
#######