#######
# @## #
##$   #
#.  . #
#   $ #
#   ###
#######