#######
#@$.###
# $.###
# #####
#  ####
#   ###
#######