#######
##  .##
##   ##
## .$ #
## $  #
###@  #
#######