#######
###  @#
### $$#
####..#
#######
#######
#######