#######
###   #
###.$@#
###.$ #
#######
#######
#######