#######
#######
##  ###
## $.##
##.$@##
##    #
#######