#######
####  #
#### .#
#### $#
# ##  #
#@$  .#
#######