#######
##   ##
#  $.##
#@$ .##
#   ###
#  ####
#######