#######
#######
# #@###
#  $###
#     #
# $. .#
#######