#######
### @ #
### $##
###   #
###.$ #
###.  #
#######