#######
#     #
# $.$@#
# .####
#  ####
# #####
#######