#######
#     #
#   $ #
#  .$@#
#.    #
#######
#######