#######
#   ###
#. $###
#     #
#   $@#
##  .##
#######