#######
##   ##
##  $@#
###$  #
##  . #
#.    #
#######