#######
#   # #
#@$   #
#  $  #
# ##. #
####. #
#######