#######
##   .#
## .$ #
### #$#
#####@#
#######
#######