#######
#     #
#@$ $ #
# ## .#
# #  .#
#     #
#######