#######
#.$ ###
#   ###
###  ##
##@$ .#
###   #
#######