#######
##.  ##
#.    #
#   $@#
####$ #
####  #
#######