#######
####  #
#@$.$ #
## .  #
##### #
##### #
#######