#######
### @ #
####$.#
#### $#
## #  #
#  .  #
#######