#######
# #   #
#@$   #
#.   .#
####$ #
###   #
#######