#######
## #  #
##  $ #
##   .#
##@$  #
## . ##
#######