#######
#######
#######
#. ####
#$$ . #
#@    #
#######