#######
#######
#######
## ####
## $. #
#@$.  #
#######