#######
# @ ###
# $####
# . ###
# $. ##
#     #
#######