#######
#..   #
#  $$ #
#   @ #
#######
#######
#######