#######
#     #
#.  $ #
#.  ###
# $####
# @ ###
#######