#######
###   #
### . #
#@$ $ #
## .  #
####  #
#######