#######
#@. ###
#$$####
#  ####
#.#####
#######
#######