#######
####@ #
####$.#
#### $#
####  #
####. #
#######