#######
#  .###
# $####
#  #  #
# . $@#
#   # #
#######