#######
#######
#######
#@#####
#$    #
#. .$ #
#######