#######
#######
###  ##
## $ ##
#@$. ##
#.    #
#######