#######
##    #
#. $ ##
## . ##
##$## #
##@   #
#######