#######
#  ####
# $   #
#@$   #
#   ..#
#######
#######