#######
##. ###
##$ ###
#   ###
#. $@##
#   ###
#######