#######
# .  ##
##   ##
### ###
## $###
##. $@#
#######