#######
#  ####
#.$####
#   $@#
#    ##
#.   ##
#######