#######
#   .##
#@$ ###
#.$ ###
#   ###
#     #
#######