#######
##### #
#  #  #
#   ..#
# $ $ #
# @ # #
#######