#######
####.##
# ##  #
# $   #
#@.$  #
####  #
#######