#######
#     #
# $ . #
####. #
####$ #
####@ #
#######