#######
#@$ .##
# $ ###
##.  ##
### ###
##    #
#######