#######
#     #
#   $ #
# # $@#
#  .  #
# #.  #
#######