#######
#. ##.#
#     #
#   $ #
# $ ###
# @ ###
#######