#######
#     #
# . $ #
#   ###
#  $###
# .@###
#######