#######
#.#####
#  ####
# $####
# $@###
#.  ###
#######