#######
#######
##@####
# $$ .#
#   . #
####  #
#######