#######
###.  #
#.    #
#   $ #
# $####
# @####
#######