#######
### @ #
# # $ #
# .   #
# . $ #
#     #
#######