#######
#######
#   ###
#. $@##
#$  ###
# .   #
#######