#######
###   #
### .$#
### $.#
### @ #
#######
#######