#######
###   #
##  . #
##. $ #
## $  #
## @ ##
#######