#######
# @$. #
# $   #
##   .#
### # #
#######
#######