#######
#  @ ##
#  $ ##
##$  ##
##. .##
##   ##
#######