#######
#  .###
# $   #
##    #
###$  #
## @ .#
#######