#######
#  .  #
#   $ #
##. $@#
#######
#######
#######