#######
#### .#
##.$  #
##  $ #
##  @ #
#######
#######