#######
#######
## .###
#@$   #
# $ . #
#   ###
#######