#######
#     #
# $@$.#
####.##
#######
#######
#######