#######
##    #
#@$   #
# $   #
#   . #
###.  #
#######