#######
#######
#######
#####.#
# . $$#
#    @#
#######