#######
###   #
#@.$  #
###   #
### $##
##  . #
#######