#######
#  ## #
#  #  #
# . $@#
# $ #.#
#   ###
#######