#######
#     #
# .$@##
# # .##
# #$ ##
#     #
#######