#######
#  @  #
#  $  #
#   .##
#  $ ##
# .   #
#######