#######
# . $@#
# . $ #
#######
#######
#######
#######