#######
#.    #
#  $ ##
#    ##
# $####
#.@####
#######