#######
#  ####
# .$ ##
# $ . #
##@   #
### ###
#######