#######
## @ ##
## $ ##
##  $ #
## . .#
##    #
#######