#######
#    ##
##.$ ##
#@$ ###
## .###
#######
#######