#######
#######
#######
# ## ##
#@$  .#
# $.  #
#######