#######
#    ##
#@$.$ #
####  #
### . #
####  #
#######