#######
####@ #
####$ #
## #. #
# $ . #
#     #
#######