#######
##   .#
#   $@#
# .   #
# $   #
#     #
#######