#######
### ###
#    .#
#     #
# $ # #
#.@ $ #
#######