#######
# .####
#  ####
#$ ####
#.$####
# @####
#######