#######
##    #
###.$@#
### $ #
####. #
####  #
#######