#######
#. #@ #
#  $$ #
#  #. #
#  ####
#  ####
#######