#######
#   @ #
#  $$ #
# ##. #
#. #  #
#  ## #
#######