#######
#@ ####
#$#####
#. ####
# .$ ##
#     #
#######