#######
#######
### . #
#  .  #
# $$  #
#  @# #
#######