#######
#. .  #
## #$ #
####@ #
####$ #
####  #
#######