#######
#  .  #
#.   ##
# # $@#
# $  ##
#     #
#######