#######
# ..  #
#    ##
#@$  ##
# $ ###
#  ####
#######