#######
#######
#######
###.# #
# $$. #
#  @  #
#######