#######
##.####
#  ####
# $@###
# $ ###
#.  ###
#######