#######
#     #
#@$  .#
#  ####
# $####
# .####
#######