#######
#  @  #
# $$ ##
#  . ##
#     #
####. #
#######