#######
# #####
# #####
# # # #
#.  $@#
#  $ .#
#######