#######
#######
#######
####  #
### $ #
# ..$@#
#######