#######
####  #
### . #
### $ #
####@ #
# . $ #
#######