#######
####  #
#    ##
#   $@#
# $  .#
#.    #
#######