#######
#     #
# $@$ #
####..#
##### #
#######
#######