#######
#.# . #
# $   #
# #   #
#$#####
#@ ####
#######