#######
# @ . #
# $$ ##
#  ####
#  ## #
# .   #
#######