#######
#.#####
#  ####
#   # #
#   $@#
# . $ #
#######