#######
#######
# .####
#.  ###
#$$####
#@ ####
#######