#######
####@ #
## #$$#
##    #
##.  .#
#######
#######