#######
#  .  #
##    #
#  #. #
## $$ #
## #@ #
#######