#######
#######
#### @#
####$$#
####..#
####  #
#######