#######
# #.###
# $   #
#@$   #
# #  .#
##### #
#######