#######
# @   #
# $$. #
#. ####
#  ####
#######
#######