#######
##### #
##.   #
###   #
### $##
###@$.#
#######