#######
### .##
##   ##
#  $ ##
# $ .##
# @  ##
#######