#######
#######
#######
# ##@##
#   $ #
#.$ .##
#######