#######
#    .#
#   $ #
# $ ###
#.@ ###
#######
#######