#######
#######
#######
####. #
#@$ $.#
##    #
#######