#######
## .###
# $   #
#@$ . #
# #   #
#  ####
#######