#######
###   #
#  .  #
#@$   #
##  $.#
###   #
#######