#######
#######
##    #
# . $ #
# @$. #
#  ####
#######