#######
# .## #
#   $@#
# . $ #
#######
#######
#######