#######
# #   #
#@$  .#
#.  $ #
#######
#######
#######