#######
#    .#
# $$  #
#@.#  #
####  #
####  #
#######