#######
#@$.  #
# $   #
##   .#
####  #
##### #
#######