#######
#### .#
##.   #
###   #
# $$  #
#  @  #
#######