#######
###.  #
###.  #
###$  #
### $##
####@##
#######