#######
#.  . #
#  #  #
#   $ #
# $  ##
# @  ##
#######