#######
#######
#######
#     #
#.  $ #
# . $@#
#######