#######
#  .  #
##    #
###  ##
#. $$##
#   @##
#######