#######
##    #
### ..#
####  #
####$$#
####@ #
#######