#######
#     #
#. # .#
#$ #  #
#  ##$#
# ###@#
#######