#######
#######
# . ###
#@$.###
# $ ###
#  ####
#######