#######
#     #
#.$   #
#  # .#
# $#  #
##@####
#######