#######
# #####
#@$ . #
#    .#
# #$  #
#     #
#######