#######
#######
#######
#  @###
#.$.$ #
#     #
#######