#######
#@$ . #
# $.  #
#######
#######
#######
#######