#######
##    #
## $. #
###  .#
#####$#
#####@#
#######