#######
#######
#######
###   #
## $  #
##@$..#
#######