#######
# $ . #
#@$   #
##### #
#####.#
####  #
#######