#######
####  #
#.  $@#
## .  #
####$ #
####  #
#######