#######
#######
## ## #
#     #
#@  $ #
#.$  .#
#######