#######
####  #
####  #
##### #
# . $@#
# . $ #
#######