#######
# $.  #
#@$ . #
# ### #
##### #
#######
#######