#######
#  @###
# $$###
#   ###
#   ###
# . .##
#######