#######
#######
#######
# #####
#  $ .#
#.  $@#
#######