#######
###.$@#
###  $#
#### .#
#######
#######
#######