#######
####@ #
####$$#
####. #
####  #
#### .#
#######