#######
### .##
### $##
##   ##
# # ###
#.  $@#
#######