#######
####@.#
####$ #
##    #
### $ #
#.    #
#######