#######
#    ##
#. $###
#  .###
##$ ###
# @####
#######