#######
#  . ##
# $ ###
##   ##
##$ ###
# @.  #
#######