#######
#  ## #
#   . #
## $. #
###@$ #
####  #
#######