#######
#.  ###
# $  ##
#  .$@#
#   ###
#######
#######