#######
#######
#  @  #
#.$.$ #
#     #
#######
#######