#######
#     #
# .   #
##$ $ #
## .@ #
#######
#######