#######
#@$  .#
# .$  #
#  #  #
##### #
#######
#######