#######
#     #
# . $ #
#  .$@#
#######
#######
#######