#######
###   #
# $   #
#   .##
# $  ##
# @  .#
#######