#######
### ###
#    ##
#. $ ##
# .$@##
### ###
#######