#######
# @####
# $####
#  ####
#  .  #
# . $ #
#######