#######
#######
####  #
##@$. #
## $  #
### . #
#######