#######
#######
#  @  #
#  $  #
#   $ #
# .  .#
#######