#######
## ####
#  @ ##
#  $$##
#     #
#..   #
#######