#######
#    .#
# $   #
#@$   #
##.  ##
#######
#######