#######
### @ #
### $$#
####  #
#### .#
####. #
#######