#######
#   . #
# $ ###
# @####
# $## #
#    .#
#######