#######
## @###
## $ ##
##$  ##
##. .##
##    #
#######