#######
#######
#######
#### ##
#  .$ #
#.  $@#
#######