#######
# @####
# $####
#   . #
# . $ #
#  ####
#######