#######
##  @ #
## $$.#
### .##
### ###
### ###
#######