#######
#   ###
# $.###
# .  ##
#  $###
## @ ##
#######