#######
# $.  #
#@$   #
# ##. #
####  #
####  #
#######