#######
#@$.  #
#  $  #
#.  ###
##  ###
#######
#######