#######
# $ . #
# . $@#
#     #
##### #
#######
#######