#######
#   @##
# .$.##
#  ####
# $####
#    ##
#######