#######
## .. #
# $$  #
#  @  #
#######
#######
#######