#######
#. $@##
# $ ###
#  ####
#  ####
# . ###
#######