#######
#######
#######
##.$@##
# # # #
#.$   #
#######