#######
#######
#######
# # ###
#@$  .#
#. $  #
#######