#######
# @####
#$$####
#  ####
#.  ###
#.  ###
#######