#######
#######
#######
##  # #
#  .$@#
#  .$ #
#######