#######
###.. #
####$ #
### @##
### $##
###   #
#######