#######
#######
## ####
# .####
# $ ###
#@$. ##
#######