#######
#######
#######
#######
### $.#
#@$  .#
#######