#######
# .  ##
##.$ ##
###@ ##
## $ ##
##   ##
#######