#######
## . .#
###$  #
##    #
### $ #
####@ #
#######