#######
# .####
#  ####
#. $ ##
#$   ##
#@#####
#######