#######
#.  .##
#   ###
#  ####
#$$ ###
#@  ###
#######