#######
# .   #
#  $@##
###.  #
## #$ #
#     #
#######