#######
##### #
#   @ #
#   $ #
# .   #
# $ . #
#######