#######
#######
#####.#
#### $#
# # $.#
#    @#
#######