#######
####  #
##. $ #
##  $@#
#   #.#
#   ###
#######