#######
# $. ##
# .  ##
###$ ##
###@ ##
#######
#######