#######
#### @#
####$$#
####. #
#### .#
##### #
#######