#######
# ##@##
#  .$ #
# $  .#
###   #
#######
#######