#######
#######
# #####
#. ####
# $.$ #
#  @  #
#######