#######
#  . ##
# $####
# @####
# $ ###
#   . #
#######