#######
#  ####
# $   #
#  .  #
#   $ #
#  #@.#
#######