#######
#######
#######
#. #  #
#   $@#
#  $. #
#######