#######
###   #
##@$  #
##. $ #
###   #
#### .#
#######