#######
#. #  #
#  #$ #
# ##  #
#   $@#
#  .  #
#######