#######
#   ###
## .###
##  ###
#  $ ##
##. $@#
#######