#######
#   # #
#   $@#
#   $ #
#  .  #
#.    #
#######