#######
#####.#
#  $. #
#  #  #
# $   #
# @   #
#######