#######
#### .#
#### $#
#### @#
#### $#
#### .#
#######