#######
###   #
###.  #
#### .#
####$$#
####@ #
#######