#######
####  #
###. .#
####  #
####$$#
####@ #
#######