#######
#######
#######
#### ##
#@$  .#
# $  .#
#######