#######
#@#####
#$#####
#.  ###
# .$ ##
#     #
#######