#######
#   @ #
#. #$ #
# #   #
#.  $ #
#     #
#######