#######
#   . #
#@$. ##
# $ ###
#   ###
#######
#######