#######
# $ . #
#@$ . #
#######
#######
#######
#######