#######
#    .#
#@$  .#
####  #
####$ #
####  #
#######