#######
#######
#######
###   #
# .$@ #
#.  $ #
#######