#######
## $..#
##   $#
#####@#
#######
#######
#######