#######
#######
###  ##
### $.#
###@$ #
###  .#
#######