#######
#   @ #
#   $ #
# ##. #
# $ . #
#     #
#######