#######
#### ##
####.##
###   #
### $ #
###@$.#
#######