#######
#     #
# $ . #
## $. #
## @  #
##### #
#######