#######
#@$ .##
#$ ####
#. ####
# ## ##
#    ##
#######