#######
##   ##
##. $ #
#  $ .#
#  @ ##
#######
#######