#######
####.@#
#### $#
####$ #
####  #
#### .#
#######