#######
# #####
#.#####
#$#####
#.$ # #
#@    #
#######