#######
#######
####. #
####  #
####$$#
####@.#
#######