#######
####  #
#@$ $ #
##    #
##.# .#
###   #
#######