#######
#  #@##
#  .$ #
#     #
# $## #
#   . #
#######