#######
#    .#
#.  $@#
# ##  #
# ##$ #
####  #
#######