#######
#.    #
#    $#
###  .#
### $ #
####@ #
#######