#######
##  ###
# . ###
# $. ##
#  $###
###@###
#######