#######
## # .#
## $  #
##    #
#### $#
####.@#
#######