#######
#    .#
# $$ ##
#.@####
# #####
#  ####
#######