#######
#    .#
#@$.  #
####  #
####$ #
####  #
#######