#######
#######
#######
##### #
#.  $@#
# . $ #
#######