#######
##    #
##  $ #
#. . ##
# $ ###
# @  ##
#######