#######
#######
#.# . #
#     #
# $ $ #
## #@ #
#######