#######
#####.#
#     #
# . $ #
# $####
# @####
#######