#######
##  ###
#   $ #
# .   #
#.##$ #
##  @ #
#######