#######
#     #
#   $ #
#..$@##
# #####
#  ####
#######