#######
#   ###
# ..###
#@$ ###
# $ ###
#    ##
#######