#######
#     #
# $ . #
###.  #
###$ ##
###@  #
#######