#######
####  #
#### .#
#### $#
### $.#
##   @#
#######