#######
####  #
####. #
####$ #
####@ #
# . $ #
#######