#######
####@ #
####$ #
###   #
# $  .#
#    .#
#######