#######
#######
### ###
#   ###
#   $@#
###.$.#
#######