#######
# .####
#  ####
#. ####
#$$ ###
# @ ###
#######