#######
#     #
#.$   #
#  $@ #
###   #
##  . #
#######