#######
##    #
##$   #
#@$   #
#  .  #
#  .  #
#######