#######
#######
####@ #
# ##$ #
#   . #
# $.  #
#######