#######
#@$  .#
#  $  #
# # ###
#. ####
#  ####
#######