#######
#@$.###
# $ ###
#  ####
# . ###
#   ###
#######