#######
####. #
#### .#
####  #
####$$#
##  @ #
#######