#######
#@$ . #
# $   #
##.####
#  ####
#   ###
#######