#######
#  ####
#$ ####
#.@  ##
#$ ####
#.#####
#######