#######
# #####
# $.  #
#@$  .#
# #####
# #####
#######