#######
####@ #
####$$#
#### .#
####. #
####  #
#######