#######
# #####
# #####
#. ####
#$ ## #
#@$.  #
#######