#######
####  #
#@$   #
# $   #
##  . #
###  .#
#######