#######
# $ . #
#@$  .#
#######
#######
#######
#######