#######
#  ####
#.$@###
# $####
# .####
#  ####
#######