#######
#  $. #
#.  $@#
####  #
#######
#######
#######