#######
#   ###
# $ ###
#  $@##
#. .###
#    ##
#######