#######
####  #
####$ #
###.  #
####$ #
####.@#
#######