#######
## ####
##  .##
#@$   #
###.$ #
###   #
#######