#######
#   . #
# .   #
#@$ $ #
# #   #
###   #
#######