#######
##  . #
#   $@#
#.   ##
##$  ##
##   ##
#######