#######
###   #
### $@#
###.$ #
###  ##
##   .#
#######