#######
#######
###   #
##@$  #
## $. #
#   . #
#######