#######
# @####
# $$ ##
#    ##
#   ..#
#    ##
#######