#######
# $  .#
#.    #
###  ##
### $##
####@##
#######