#######
###   #
##  $ #
##..  #
##  $##
##  @ #
#######