#######
#######
#######
#   .##
# $ ###
#.  $@#
#######