#######
####  #
#   $@#
#   $.#
##.#  #
##### #
#######