#######
##    #
## $  #
##   .#
##  .$#
##   @#
#######