#######
#######
#.@## #
# $ $ #
#     #
#  .###
#######