#######
#######
#### ##
#     #
# .$@##
# $. ##
#######