#######
##  .##
##   ##
#  $@##
#. $ ##
#     #
#######