#######
#   ###
## $@ #
#   $ #
#.  . #
#     #
#######