#######
#     #
#.$   #
###$  #
###@. #
##### #
#######