#######
#  @###
# $$###
#. .###
## ####
#######
#######