#######
#######
##### #
##    #
##.$  #
##@$. #
#######