#######
####@ #
####$.#
#### $#
##    #
#   . #
#######