#######
###@. #
###$  #
##   .#
## $  #
#     #
#######