#######
#  @  #
# .$$ #
###.###
#######
#######
#######