#######
#  .  #
#  #  #
#  ## #
#   $ #
#  .$@#
#######