#######
#######
#  #.##
#    ##
# $   #
#@. $ #
#######