#######
#######
# #####
#. # ##
#$ .$@#
#    ##
#######