#######
#######
##### #
#####.#
## # $#
## .$@#
#######