#######
#@#####
#$#####
#    ##
#. .$ #
#     #
#######