#######
#######
#### ##
#  . .#
# $$  #
# @   #
#######