#######
#### @#
### $$#
####  #
####  #
###. .#
#######