#######
#######
###@ ##
###$$##
#    ##
#   ..#
#######