#######
#     #
#.  . #
# $   #
### $##
####@##
#######