#######
#     #
#  #  #
# ##. #
# $.$ #
#   @ #
#######