#######
##   @#
##  $$#
##  # #
## .  #
###  .#
#######