#######
#.#####
#$ ####
#@ ####
#$#####
#. ####
#######