#######
#######
# #####
#..####
#$$####
# @  ##
#######