#######
#    .#
#   $ #
####. #
#@$   #
#     #
#######