#######
#######
# # @##
# $ $.#
#.    #
#     #
#######