#######
#######
#######
#. ####
#   $@#
# . $ #
#######