#######
# #  ##
#     #
#..  ##
#$$####
# @####
#######