#######
#######
#######
#######
#   ###
#.$@$.#
#######