#######
## @  #
#. $  #
#.    #
##  $ #
#     #
#######