#######
####  #
### $ #
###   #
#.   ##
# . $@#
#######