#######
####. #
#### .#
####$$#
#### @#
#######
#######