#######
###  .#
##   .#
##@$  #
##   $#
##    #
#######