#######
#.$@###
# $####
# .####
# #####
#######
#######