#######
#######
##  ###
##.  ##
##  $@#
#.  $ #
#######