#######
# ..###
#   ###
#   ###
#  $$ #
#  @  #
#######