#######
#.   ##
#  $@##
# .$###
#   ###
## ####
#######