#######
#     #
# $. .#
###$  #
###@  #
##### #
#######