#######
#.    #
# . $@#
###   #
###$  #
###  ##
#######