#######
#  .###
#.  ###
#  $###
##$ ###
##@####
#######