#######
#     #
#@$. ##
# $ ###
# .####
#   ###
#######