#######
# @#  #
# $#$ #
#   . #
#  .# #
#######
#######