#######
####  #
###@  #
# $$ ##
#  . ##
#   .##
#######