#######
#######
####. #
### $ #
###.$@#
##    #
#######