#######
#######
####  #
#### .#
# ## $#
# . $@#
#######