#######
# @####
#$$ ###
#   ###
# .####
#. ####
#######