#######
###   #
###.$ #
###   #
###$. #
###@ ##
#######