#######
#  .  #
#   $ #
# $.###
# @####
# #####
#######