#######
#   ###
# $.###
#@$ . #
#    ##
#     #
#######