#######
### . #
####  #
###   #
## $$ #
##. @##
#######