#######
#     #
#   $@#
#.#   #
# . $ #
# ##  #
#######