#######
#  ####
# $ ###
#@$.###
##  ###
##  . #
#######