#######
#.    #
#   $@#
#$ ####
#  ####
# .####
#######