#######
#  ####
# $#.##
#  # .#
#@$   #
#     #
#######