#######
##    #
# $  .#
#@$   #
# #  .#
#######
#######