#######
#    ##
# .$ ##
##$ .##
##@####
#######
#######