#######
#    .#
# . $@#
#    ##
# $  ##
#     #
#######