#######
##    #
#  .  #
#  $###
##$ .##
##@   #
#######