#######
#.#####
# .####
#   ###
# $$ ##
# @   #
#######