#######
####@ #
####$ #
####  #
# .   #
# $.  #
#######