#######
# .@  #
#  $  #
#   $ #
#  .  #
##### #
#######