#######
#     #
#   $.#
#   ###
#  $###
#. @###
#######