#######
# . $ #
#@$.  #
#     #
#######
#######
#######