#######
#.    #
#   . #
#$$ ###
#@  ###
#######
#######