#######
####  #
# ##$ #
#  .  #
#@$   #
#.    #
#######