#######
## ####
##    #
#  .  #
#@$ $ #
## .  #
#######