#######
#   . #
# $$ .#
# @ ###
#######
#######
#######