#######
##@####
# $   #
# . .##
# #$ ##
#     #
#######