#######
#     #
# @$. #
# ##  #
#.##$ #
####  #
#######