#######
#. ####
#$#####
#@#####
#$#####
#. ####
#######