#######
#     #
# $   #
#@$ # #
###.  #
###.  #
#######