#######
#   ###
# ..# #
#     #
# $ $ #
# @## #
#######