#######
#   . #
# $ $@#
##.  ##
### ###
### ###
#######