#######
#.  $ #
#   $@#
#.  ###
#  ####
#  ####
#######