#######
###   #
### .##
####  #
# ##$ #
#@$  .#
#######