#######
#     #
#   $@#
# $   #
#.  . #
#######
#######