#######
###  ##
### $##
#  .  #
# $   #
#@.   #
#######