#######
# @####
# $$ ##
# .  ##
#    ##
#.## ##
#######