#######
#######
#######
####.##
# # $ #
#@$  .#
#######