#######
#######
###.  #
##. $@#
## $  #
##    #
#######