#######
##@####
# $  ##
# . .##
# $ ###
#   ###
#######