#######
##  @ #
### $$#
####  #
####..#
##### #
#######