#######
## ####
##.####
#   ###
#.$$ ##
# @  ##
#######