#######
#.  $@#
#  $.##
###  ##
#### ##
#######
#######