#######
##### #
### . #
###@$ #
# # $ #
#    .#
#######