#######
## . ##
##  $ #
##  #.#
## $  #
###@  #
#######