#######
# ## .#
#@$ $ #
#.    #
#######
#######
#######