#######
#     #
#@.   #
##$ $ #
##  ###
## . ##
#######