#######
#### @#
####$$#
####  #
####. #
#####.#
#######