#######
# @ ###
#$$####
#. ####
#  .###
#  ####
#######