#######
#######
#######
#### .#
#### $#
###.$@#
#######