#######
###   #
####$ #
####.@#
### $##
### . #
#######