#######
#######
#### .#
####. #
####$$#
####@ #
#######