#######
###   #
# . $@#
#   $ #
#     #
#  .  #
#######