#######
#######
# #.###
#.$   #
#   $@#
#    ##
#######