#######
# @##.#
# $#  #
#   #$#
#     #
# .# ##
#######