#######
#  $. #
#.  $@#
#  ####
# #####
# #####
#######