#######
#######
#######
# #   #
#@$   #
# $.. #
#######