#######
# . @ #
##  $ #
###$  #
##    #
## .  #
#######