#######
###   #
##.   #
### $ #
##  @##
#.$ ###
#######