#######
# .   #
# .$$ #
# ##@ #
##### #
####  #
#######