#######
####. #
####$ #
####@ #
####$ #
### . #
#######