#######
#     #
#  $  #
#  $@ #
#.    #
###  .#
#######