#######
#     #
#   $@#
#. .  #
#   $ #
#     #
#######