#######
#  ..##
##  ###
##  ###
# #$$ #
#  @  #
#######