#######
#######
#######
#.#####
#   $@#
#  $ .#
#######