#######
##   ##
##  $##
##   ##
#.. $@#
#     #
#######