#######
# ### #
#     #
# . $ #
# $## #
#@.####
#######