#######
#.  @ #
#   $ #
#  .  #
#   $ #
# #   #
#######