#######
####@ #
## $$ #
##    #
##.#. #
##### #
#######