#######
#  @ ##
#  $###
#   ###
#.  $ #
#.    #
#######