#######
#  ####
# ##.##
# $.  #
#@$   #
# #  ##
#######