#######
##  #.#
##@$  #
### $ #
### #.#
###   #
#######