#######
##    #
#.$   #
#    @#
#   $.#
#    ##
#######