#######
##  . #
## $ .#
####  #
####$ #
### @ #
#######