#######
###  .#
###   #
#### .#
####$$#
####@ #
#######