#######
#  @###
# $$###
#. .###
# #####
#######
#######