#######
#.  ###
# $@###
# $####
#  ####
#.#####
#######