#######
#  @ ##
#  $###
# ..###
#   $ #
#     #
#######