#######
#.   @#
#   $$#
####  #
##    #
##   .#
#######