#######
#######
##### #
##    #
##@$. #
##. $ #
#######