#######
####. #
#### .#
####  #
####$$#
#### @#
#######