#######
#    ##
#.   ##
#  $@##
#.$ ###
#  ####
#######