#######
#@   ##
#$$ ###
# . ###
#.# ###
#######
#######