#######
#######
#######
####  #
#@$ . #
# $.  #
#######