#######
#     #
#.$   #
### $@#
##    #
#### .#
#######