#######
#     #
#.$   #
#   $@#
#  ####
#  .###
#######