#######
##### #
#  ## #
#   $@#
# $ . #
#  .  #
#######