#######
#.@   #
# $ $ #
#    ##
##. ###
#######
#######