#######
#### .#
####  #
####. #
####$$#
####@ #
#######