#######
####  #
# $ . #
#   . #
###$ ##
###@ ##
#######