#######
# @  ##
# $$.##
#   ###
#  ####
# . ###
#######