#######
### @ #
### $ #
## $  #
##  . #
### . #
#######