#######
#######
#.$@###
#. ####
#$ ####
#     #
#######