#######
#######
#     #
# .  .#
# $ $ #
# @   #
#######