#######
##@.  #
##$  ##
#   .##
# $  ##
#    ##
#######