#######
#.  ###
##   ##
#.  $##
#  $  #
#  @  #
#######