#######
###  ##
###$ ##
###.  #
###  ##
###.$@#
#######