#######
####  #
####$ #
### . #
#@$  .#
###   #
#######