#######
#    ##
#  ..##
#@$  ##
##$  ##
##   ##
#######