#######
####@##
##  $ #
##    #
## $ .#
# .   #
#######