#######
##@####
##$####
#  .###
#  $# #
# .   #
#######