#######
##    #
##  .@#
##  $ #
## $. #
##  # #
#######