#######
####  #
#.##  #
# # # #
#   $@#
#  $. #
#######