#######
#   ###
#.  $@#
#.   ##
#  $ ##
#     #
#######