#######
#     #
#.$@$.#
#### ##
#######
#######
#######