#######
#######
#######
##### #
### $.#
##@$ .#
#######