#######
# $.  #
#@$ . #
# #####
#######
#######
#######