#######
#@ ####
#$#####
# #####
# $.###
#.  ###
#######