#######
#     #
#   $@#
#  #. #
#  #$ #
# .   #
#######