#######
#    ##
#  . ##
#  $###
# $  ##
#.@   #
#######