#######
##.   #
##  $ #
##  $@#
##   .#
##    #
#######