#######
#######
##.# ##
# .$@ #
#   $ #
#    ##
#######