#######
# $ . #
# . $@#
#   ###
#######
#######
#######