#######
#  .###
#   ###
#  ####
##$####
#.$@###
#######