#######
###   #
##. $ #
##@$ .#
#######
#######
#######