#######
##  . #
### $ #
##@$ .#
####  #
#######
#######