#######
#     #
#..$ ##
#  # ##
# $ ###
# @ ###
#######