#######
### . #
## .  #
### $ #
### $@#
##    #
#######