#######
#.  ###
# $ ###
#   ###
#$  ###
#.@ ###
#######