#######
#     #
#@  $ #
#.$   #
####.##
#######
#######