#######
#######
#### .#
## .  #
## $$ #
##  @ #
#######