#######
##### #
#.    #
##  $@#
##  $ #
## .  #
#######