#######
####@ #
####$$#
###.  #
###  .#
#######
#######