#######
###@  #
## $  #
##$ . #
#   ###
#  . ##
#######