#######
# @ ###
#$$####
#  ####
#  ####
#..####
#######