#######
#   ###
# .$@ #
#  $. #
#  ####
#######
#######