#######
##  @##
##  $##
##.   #
##  $ #
##  . #
#######