#######
#    ##
# .$@##
##$ ###
##   ##
###.###
#######