#######
#.@####
# $####
#$ ####
#  ## #
#   . #
#######