#######
## . ##
##  ###
### ###
## $  #
##@$ .#
#######