#######
# .####
#. ####
# $####
#$ ####
#@#####
#######