#######
#######
##### #
####..#
####$$#
### @ #
#######