#######
#####.#
#####.#
# $@$ #
#     #
# #####
#######