#######
#######
#. .  #
#   $ #
#  $# #
#  @ ##
#######