#######
#. @ ##
#  $ ##
#    ##
#$  ###
# . ###
#######