#######
##  @##
##$ $##
##    #
#  .  #
#  .  #
#######