#######
#######
#.##  #
#  #$ #
#  .$@#
#     #
#######