#######
####  #
# ..  #
#     #
# $ $ #
# @ # #
#######