#######
#  ####
# #####
#   ###
#.  $@#
# $ . #
#######