#######
#@$  .#
# .$  #
#######
#######
#######
#######