#######
#######
## @###
##$$ ##
##   ##
# .  .#
#######