#######
## .. #
##  $ #
####  #
####$ #
####@ #
#######