#######
# $  .#
#@$   #
##   .#
#  #  #
#  #  #
#######