#######
# . $ #
# . $@#
#  ####
# #####
# #####
#######