#######
##    #
#  .  #
#.$$ ##
# @####
#######
#######