#######
#. @###
#  $ ##
#    ##
#$. ###
#  ####
#######