#######
####. #
###.  #
# $$  #
#  @  #
#######
#######