#######
# #####
#  .  #
#    .#
##$ $ #
##  @ #
#######