#######
#######
### @.#
### $ #
# # .$#
#     #
#######