#######
#######
#######
#######
# .$ ##
# . $@#
#######