#######
# .$@##
#   ###
#$#####
#   ###
#. ####
#######