#######
####@ #
####$ #
###   #
###.$ #
###.# #
#######