#######
##   .#
## .  #
##    #
#@$ $ #
##   ##
#######