#######
#@    #
#$$. ##
#  ####
#.#####
# #####
#######