#######
# .   #
# ## .#
####  #
####$$#
###  @#
#######