#######
##### #
####@.#
### $ #
###  $#
###  .#
#######