#######
#######
#######
#######
##.$ ##
# . $@#
#######