#######
#######
##@# ##
# $   #
#.  $ #
#. # ##
#######