#######
#.  ###
#. ####
# $ ###
# $@###
#     #
#######