#######
#######
##### #
####  #
### $.#
#@$ . #
#######