#######
####. #
####$ #
# ##  #
#@$  .#
#     #
#######