#######
###@###
## $###
##    #
#   $ #
#  . .#
#######