#######
#   ###
# .####
#  .###
# $$###
# @ ###
#######