#######
#  .$ #
#@$ . #
#    ##
# #####
#######
#######