#######
#     #
#   $.#
#   ###
## $###
##.@###
#######