#######
#######
#######
#  #. #
#@$.$ #
#     #
#######