#######
# $ ..#
#     #
##### #
#### $#
#### @#
#######