#######
### @##
### $ #
###  .#
### $ #
###  .#
#######