#######
#  .###
#   ###
###$# #
###.$ #
###@  #
#######