#######
#######
#####.#
###  .#
### $$#
#    @#
#######