#######
# $  .#
#@$  .#
#######
#######
#######
#######