#######
#@  ###
#$$ ###
#  ####
#. ####
# .####
#######