#######
#######
####@ #
####$$#
####  #
#.   .#
#######