#######
##### #
#. ## #
# $   #
# . $ #
#   @ #
#######