#######
##.   #
##  $ #
###   #
###$. #
###@  #
#######