#######
# $.$.#
#  @  #
#######
#######
#######
#######