#######
#  ####
# $####
#@$ . #
#  . ##
#    ##
#######