#######
##### #
##### #
#.  $@#
# . $ #
#   # #
#######