#######
#. ####
#  ## #
#    .#
# $ $ #
# @####
#######