#######
#######
#######
# .##.#
#   $$#
#    @#
#######