#######
###  @#
###.$$#
#####.#
####  #
####  #
#######