#######
#######
#. ####
# ### #
# $.$ #
#  @  #
#######