#######
# $  .#
#@$   #
# ##  #
####  #
####. #
#######