#######
###   #
#  $  #
#@$   #
###   #
###.. #
#######