#######
#######
# # .##
#@$  .#
# $   #
###   #
#######