#######
#  ####
#  $@##
# . ###
# $ ###
#. ####
#######