#######
#   @ #
#  $$ #
#.# .##
#######
#######
#######