#######
## .@ #
##  $##
###  ##
### $ #
##.   #
#######