#######
#   ..#
# $   #
###$  #
###@ ##
#######
#######