#######
# #####
#.  ###
#  $###
# $.###
##@####
#######