#######
#@$. ##
# $. ##
# # ###
# #  ##
### ###
#######