#######
#######
#######
#######
#  .$ #
# . $@#
#######