#######
#######
#    .#
#   # #
# $   #
#@$ . #
#######