#######
##  ###
#  .###
# $ ###
#@$ ###
# .   #
#######