#######
# @####
# $#  #
#   $ #
#  .  #
#    .#
#######