#######
#   ..#
# $#  #
# @ ###
# $####
#  ####
#######