#######
#######
#######
####. #
### $ #
###@$.#
#######