#######
#  .  #
#     #
# .#  #
#  $$ #
#   @ #
#######