#######
#######
#  ####
# . $@#
# $ # #
#  . ##
#######