#######
## ## #
##   .#
##. $@#
####$ #
####  #
#######