#######
#    .#
# $$  #
##@# .#
##### #
#######
#######