#######
#######
#######
#     #
# . $@#
## $ .#
#######