#######
####@ #
####$$#
#### .#
### . #
#     #
#######