#######
##   .#
##    #
###$  #
### $ #
###@. #
#######