#######
#  ####
#  $@##
# .$ ##
##  ###
##  .##
#######