#######
#  # ##
# .  .#
# $$ ##
# @####
# #####
#######