#######
#     #
## . .#
#@$   #
##  $ #
##    #
#######