#######
#    @#
#.  $$#
## ## #
## #  #
## # .#
#######