#######
#.  $ #
#   $@#
#.  # #
# #####
#   ###
#######