#######
##    #
## . .#
##  $@#
##  $ #
##    #
#######