#######
#  ####
# .   #
#   $ #
#   $@#
#.  ###
#######