#######
###  .#
### $ #
### @##
### $ #
### . #
#######