#######
#. .###
#  ####
# $ ###
# $@###
#   ###
#######