#######
###.  #
### $ #
###   #
###$  #
## @. #
#######