#######
## .  #
#.  $ #
###   #
### $ #
####@ #
#######