#######
####. #
##   .#
#     #
# $ $ #
#   @ #
#######