#######
#  ####
#    .#
#   $ #
# $.###
# @ ###
#######