#######
###   #
##   ##
##$  ##
#@$ .##
#   .##
#######