#######
##   .#
## $  #
###  ##
# #$ ##
#  @. #
#######