#######
####  #
####. #
#   $ #
#@$   #
#   . #
#######