#######
#.   ##
# $  ##
#  .###
#$### #
#@    #
#######