#######
##   .#
## .$ #
####  #
### $ #
### @ #
#######