#######
#######
####@ #
####$ #
#  .  #
## $ .#
#######