#######
##### #
##   .#
###. $#
### $ #
### @ #
#######