#######
###   #
### $ #
##@#  #
# $.  #
#   . #
#######