#######
#######
###@###
# .$###
# $ ###
#   . #
#######