#######
#######
# #####
#  #@ #
# .$$ #
#  .  #
#######