#######
###@  #
###$.##
###   #
## $  #
#  .  #
#######