#######
#######
#######
###@###
#.$.$ #
#     #
#######