#######
#######
#    ##
# $..##
#@$ ###
#   ###
#######