#######
#   ###
#@$ ###
# $ ###
#     #
##. . #
#######