#######
#######
#######
### # #
# . $@#
#  .$ #
#######