#######
# . $ #
#     #
#   . #
# $ # #
##@####
#######