#######
#   .##
# $  ##
###  ##
###.$ #
####@ #
#######