#######
#  @  #
#  $. #
# $.  #
#  ## #
#######
#######