#######
#  .. #
#     #
# $ $ #
### @ #
#######
#######