#######
#######
#######
#### .#
# ## $#
#  .$@#
#######