#######
##  . #
####$ #
####@ #
####$ #
####. #
#######