#######
#######
## ##.#
#  .  #
# $$  #
#  @###
#######