#######
#######
#######
## ####
#.$ ###
#.  $@#
#######