#######
#######
#   . #
#  . ##
# $ $ #
# @   #
#######