#######
#     #
#@$   #
#. $.##
# #####
# #####
#######