#######
#  ####
# $####
#@$  ##
#  .  #
#  . ##
#######