#######
#######
#   .##
#.   ##
# $$###
#  @###
#######