#######
# @####
#.$ ###
#$ ####
#  ####
# .####
#######