#######
###@###
##.$ ##
## . ##
## $ ##
#    ##
#######