#######
#####.#
###   #
###  $#
### $.#
####@ #
#######