#######
# . . #
# $#  #
# @ ###
# $ ###
#  ####
#######