#######
#   ###
#$ $@##
#..####
#######
#######
#######