#######
#     #
#@$. ##
# $####
# . ###
#     #
#######