#######
#  .$ #
#@$  .#
#     #
#######
#######
#######