#######
# ..###
#   ###
##  ###
## $$ #
## @  #
#######