#######
#### @#
####$$#
####  #
## # .#
# .   #
#######