#######
# @   #
# $ . #
#  . ##
# $ ###
##  ###
#######