#######
##   ##
## $###
##@.  #
## $# #
##   .#
#######