#######
# #.  #
#. $$ #
# # @##
#  ####
#   ###
#######