#######
##    #
## .$@#
### $ #
## .###
##    #
#######