#######
#######
#######
#     #
# $  ##
#. .$@#
#######