#######
#######
#######
#######
###@  #
#.$.$ #
#######