#######
#### .#
###   #
### $.#
#####$#
#####@#
#######