#######
####  #
##### #
####  #
#.  $@#
## $. #
#######