#######
#.  ###
# . $@#
#    ##
###$ ##
###   #
#######