#######
#######
### . #
###  $#
### $.#
####@ #
#######