#######
###   #
###@$.#
####$ #
####.##
###  ##
#######