#######
#### @#
####$$#
####  #
###  .#
### . #
#######